   WE                            assets/WE.xpm
NO      assets/NO.xpm



SO assets/SO.xpm

F      17,    38,     255

EA assets/eagle.xpm

C 255, 234, 235

        1111111111111111111111111
        1000000000110000000000111        111111111111111
        101100000111000011100000111111111111100000N001
        10010000000000001 100000111111111111111111111111
111111111011000001110000111000001
100000000011000001110111111111111
11110111111111011100000010001
11110111111111011101010010001
11000000110101011100000010001
10000000000000001100000010001
10000000000000001101010010001
1100000111010101111101111000111
11110111 1110101 100111010001
11111111 1111111 111111111111