WE                            assets/WE.xpm
NO      assets/NO.xpm
SO assets/SO.xpm

F      255,    255,     255

EA assets/EA.xpm

C 255, 255, 255

        111111111111111111111111
        1000000000110000000000111        111111111111111
        10110000011100001110000011 111111111110000001
        10010000000000001 10000011 1111111111111111111111
111111111011000001110000111000001
100000000011000001110111111111111
11110111111111011100000010001
11110111111111011101010010001
1100000110101011100000010001
1000000000000001100000010001
100000000S0000001101010010001
1100000111010101111101111000111
11110111 1110101 10011101001
11111111 1111111 11111111111