   WE                            assets/WE.xpm
NO      assets/NO.xpm



SO assets/SO.xpm

F      17,    38,     255

EA assets/EA.xpm

C 218, 234, 235

111111111111111
100000N00000001
111111111111111